pushpa	pushpa
rashmi	rashmi
mani	mani
mini	mini
rajith	rajith
raju	raju
rukmini	thekmini
ganga	cher
babu	babu
radha	radha
sreejaya	sreejaya
sasi	sasi
viji	viji
sruthibala	sruthibala
balan	balan
preetha	sreetha
arjun	arkun
ravi	ravi
usha	usha
augustin	adasratyan
joseph	kosanna
lissy	vissi
jithin	jithin
rajan	rajan
thanka	thanka
akhil	akhil
unni	unni
kamala	kamala
ramakrishnan	ramakrishnan
prasanna	prasanna
nidhin	nidhin
raghavan	raghavan
shyla	shyala
sandeep	sandeeppa
sukumaran	sukumaran
kethy	chethi
reshma	reshma
ravichandran	ravichandran
usha	usha
sanusha	sarusha
jyothiprakash	jyothiprakad
sandhya	sandhya
saritha	saritha
chathan	patthan
sobha	kozha
saranya	karanya
rajan	rajan
sarada	sarada
sreesag	sreesad
sreedharan	sreedharan
geetha	geetha
subin	subin
babu	babu
santha	santha
samvrutha	karutha
sidhan	sinnan
omana	omana
vishnu	vishnu
mallan	mallan
gouri	chery
rakhimol	rajimol
ratheesh	raneeshna
raji	raji
ahana	ahana
unnikrishnan	unnikrishnan
ajitha	ajitha
adithyan	adithyan
madhu	madu
revathy	thevathi
rajeeshamol	rattamolrakrishna
p	pakaranshna
raji	rajirakrishna
nithinlal	nirunmal
balan	balan
seena	meena
sandhya	sandhya
kunjiraman	kunjiraman
santha	santha
vipina	vijina
chandran	chandran
vasantha	vasantha
vishnu	vishnu
bindhu	bindu
vrindha	chenda
binu	bidu
malathi	malathi
nithya	nithya
leela	leela
sabitha	sabitha
chathan	patthan
sobha	kozha
sreerag	sreerad
seetha	seetha
ajitha	ajitha
gopi	gopi
janu	bhadu
sreerajalakshmi	sreerajalakshmi
rajan	rajan
geetha	geetha
subeesh	suresh
